██████████████████████████████████████████████████████████████████████████████████████████████████████████████████▓▓██████████▓▓████▓▓▓▓▓▓▓▓▓▓▓▓▓▓▓▓▓▓▓▓▓▓▓▓▓▓▓▓▓▓▓▓▓▓▓▓▓▓▓▓▓▓▓▓▓▓▓▓▓▓▓▓▓▓▓▓▓▓
████████████████▓▓██████████████▓▓████████▓▓▓▓▓▓██▓▓██████▓▓██████████████████████████████████████▓▓▓▓██▓▓██▓▓██▓▓▓▓████▓▓▓▓▓▓▓▓▓▓▓▓██▓▓▓▓▓▓▓▓▓▓▓▓▓▓▓▓▓▓▓▓▓▓▓▓▓▓▓▓▓▓▓▓▓▓▓▓▓▓▓▓▓▓▓▓▓▓▒▒▓▓▓▓▓▓▓▓
████████████████████████████████████████████████▓▓▓▓▓▓▒▒▒▒▓▓▓▓██▓▓████████████████████████████▓▓████▓▓▓▓▓▓▓▓▓▓▓▓██▓▓▓▓▓▓████▓▓▓▓▓▓▓▓▓▓▓▓▓▓▓▓▓▓▓▓▓▓▓▓▓▓▓▓▓▓▓▓▓▓▓▓▓▓▓▓▓▓▓▓▓▓▓▓▓▓▓▓▓▓▓▓▓▓▓▓▓▓▓▓▓▓
████████████████████████████████████████████████████▓▓▒▒▒▒▓▓▓▓████▓▓██████████████████▓▓██▓▓▓▓▓▓▓▓▓▓▓▓▓▓▓▓██▓▓██▓▓▓▓▓▓▓▓██▓▓██▓▓▓▓▓▓▓▓▓▓▓▓▓▓▓▓▓▓▓▓▓▓▓▓▓▓▓▓▓▓▓▓▓▓▓▓▓▓▓▓▓▓▓▓▓▓▓▓▓▓▓▓▓▓▓▓▓▓▓▓▓▓▒▒
████████████▓▓████████████████████████████████████████▓▓██▓▓██▓▓██▓▓▓▓▓▓▓▓▓▓████▓▓██▓▓▓▓████▓▓▓▓▓▓▓▓▓▓▓▓▓▓▓▓▓▓▓▓▓▓▓▓▓▓▓▓▓▓▓▓▓▓▓▓▓▓▓▓▓▓▓▓▓▓▓▓▓▓▓▓▓▓▓▓▓▓▓▓▓▓▓▓▓▓▓▓▓▓▓▓▓▓▓▓▓▓▓▓▓▓▓▓▓▓▓▓▓▓▓▓▓▓▓▓▒▒
██████████████████████████████████████████████████████████▓▓██▓▓▓▓██████▓▓▓▓██▓▓▓▓██▓▓██▓▓██▓▓▓▓▓▓▓▓▓▓▓▓▓▓▓▓▓▓▓▓▓▓▓▓▓▓▓▓▓▓▓▓▓▓▓▓▓▓▓▓▓▓▓▓▓▓▓▓▓▓▓▓▓▓▓▓▓▓▓▓▓▓▓▓▓▓▓▓▓▓▓▓▓▓▓▓▓▓▓▓▓▓▓▓▓▓▓▓▓▓▓▓▓▓▒▒▒▒
██████████████████████████████████████████████████████████████████████████▓▓██▓▓██▓▓▓▓▓▓▓▓▓▓▓▓▓▓▓▓▓▓▓▓██▓▓▓▓▓▓▓▓▓▓▓▓▓▓▓▓▓▓▓▓▓▓▓▓▓▓▓▓▒▒▓▓▓▓▓▓▓▓▓▓▓▓▓▓▓▓▓▓▓▓▓▓▓▓▓▓▓▓▓▓▓▓▓▓▓▓▓▓▓▓▓▓▓▓▓▓▓▓▓▓▓▓▓▓▓▓
████████████████████████████████████████████████████████▓▓██▓▓▓▓▓▓▓▓▓▓▓▓▓▓██▓▓▓▓▓▓▓▓▓▓▓▓▓▓▓▓▓▓▓▓▓▓▓▓▓▓▓▓▓▓▓▓▓▓▓▓▓▓▓▓▓▓▒▒▓▓▓▓▓▓▓▓▓▓▓▓▓▓▓▓▓▓▓▓▓▓▓▓▓▓▓▓▓▓▓▓▓▓▓▓▓▓▓▓▓▓▓▓▓▓▓▓▓▓▓▓▓▓▓▓▓▓▓▓▓▓▓▓▓▓▓▓▓▓
████████████████████████████████████████████████████████▓▓▓▓▓▓▓▓▓▓████▓▓▓▓▓▓▓▓▓▓▓▓▓▓▓▓▓▓▓▓▓▓▓▓▓▓▓▓▓▓▓▓▓▓▓▓▓▓▓▓▓▓▓▓▓▓▓▓▓▓▓▓▓▓▓▓▓▓▓▓▓▓▓▓▓▓▓▓▓▓▓▓▓▓▓▓▓▓▓▓▓▓▓▓▓▓▓▓▓▓▓▓▓▓▓▓▓▓▓▓▓▓▓▓▓▓▓▓▓▓▓▓▓▓▓▓▓▓▓▓
██████▓▓██████████████████████████████████████▓▓▓▓▓▓▓▓▓▓▓▓▓▓████▓▓▓▓▓▓▓▓▓▓▓▓▓▓▓▓▓▓▓▓▓▓▓▓▓▓▓▓▓▓▓▓▓▓▓▓▓▓▓▓▓▓▓▓▓▓▒▒▓▓▓▓▓▓▓▓▓▓▓▓▓▓▓▓▓▓▓▓▓▓▓▓▓▓▓▓▓▓▓▓▓▓▓▓▓▓▓▓▓▓▓▓▓▓▓▓▓▓▓▓▓▓▓▓▓▓▓▓▓▓▓▓▓▓▓▓▓▓▓▓▓▓▓▓▓▓
████▓▓████████████████████████████████▓▓▓▓▓▓██████▓▓██████████▓▓▓▓▓▓▓▓▓▓▓▓▓▓▓▓▓▓▓▓▓▓▓▓▓▓▓▓▓▓▓▓▓▓▓▓▓▓▓▓▓▓▓▓▓▓▓▓▓▓▓▓▓▓▓▓▓▓▓▓▓▓▓▓▓▓▓▓▓▓▓▓▓▓▓▓▓▓▓▓▓▓▓▓▓▓▓▓▓▓▓▓▓▓▓▓▓▓▓▓▓▓▓▓▓▓▓▓▓▓▓▓▓▓▓▓▓▓▓▓▓▓▓▓▓▓▓▓
████████████████████████████████████████▓▓▓▓██▓▓██▓▓▓▓▓▓▓▓▓▓▓▓▓▓▓▓▓▓▓▓▓▓▓▓▓▓▓▓▓▓▓▓▓▓▓▓▓▓▓▓▓▓▓▓▓▓▓▓▓▓▓▓▓▓▓▓▓▓▓▓▓▓▓▓▓▓▓▓▓▓▓▓▓▓▓▓▓▓▓▓▓▓▓▓▓▓▓▓▓▓▓▓▓▓▓▓▓▓▓▓▓▓▓▓▓▓▓▓▓▓▓▓▓▓▓▓▓▓▓▓▓▓▓▓▓▓▓▓▓▓▓▓▓▓▓▓▓▓▓▓
████████████████████████████████▓▓██▓▓▓▓▓▓██▓▓██▓▓▓▓▓▓▓▓▓▓▓▓▓▓▓▓██▓▓▓▓▓▓▓▓▓▓▓▓▓▓▓▓▓▓▓▓▓▓▓▓▓▓▓▓██▓▓████████▓▓▒▒▓▓▓▓▓▓▓▓▓▓▓▓▓▓▓▓▓▓▓▓▓▓▓▓▓▓▓▓▓▓▓▓▓▓▓▓▓▓▓▓▓▓▓▓██▓▓▓▓▓▓▓▓▓▓▓▓▓▓▓▓▓▓██▓▓▓▓▓▓▓▓▓▓██▓▓
████████████████████████████▓▓██▓▓▓▓▓▓██▓▓▓▓▓▓██▓▓▓▓▓▓▓▓▓▓▓▓▓▓▓▓▓▓▓▓▓▓▓▓▓▓▓▓▓▓▓▓▓▓▓▓▓▓██▓▓▓▓▓▓██▓▓██▓▓██▓▓▓▓▒▒▒▒▒▒▓▓▒▒▓▓██▓▓▓▓▓▓▓▓▓▓▓▓▓▓▓▓▓▓▓▓▓▓████████▓▓████████▓▓██▓▓████▓▓▓▓▓▓▓▓▓▓▓▓▓▓▓▓▓▓
████████████████████████▓▓▓▓██▓▓▓▓████▓▓██▓▓▓▓▓▓▓▓▓▓▓▓▓▓▓▓▓▓▓▓▓▓▓▓▓▓▓▓▓▓▓▓▓▓▓▓████▓▓██▓▓▓▓██████▓▓██████████████▓▓▓▓▒▒▒▒▒▒▓▓██▓▓▓▓▓▓▓▓▓▓▓▓▓▓██████████████████████▓▓████████▓▓██████▓▓████▓▓▓▓
██████████████████████▓▓▓▓▓▓▓▓▓▓██▓▓▓▓▓▓██▓▓██▓▓▓▓▓▓▓▓▓▓▓▓▓▓▓▓▓▓▓▓▓▓▓▓▓▓▓▓▓▓▓▓▓▓██████▓▓██████████████████████████████████▓▓▒▒▓▓▓▓▓▓▓▓▒▒▒▒▒▒▒▒▒▒▒▒▒▒▒▒▒▒▒▒▒▒▒▒▒▒▒▒▒▒▒▒▓▓▓▓▓▓▓▓██████████▓▓▓▓▓▓
████████████▓▓██████▓▓██▓▓▓▓▓▓▓▓▓▓▓▓▓▓▓▓██▓▓██▓▓▓▓▓▓▓▓▓▓▓▓▓▓▓▓▓▓▓▓████████▓▓████▓▓████████████████████████▓▓▓▓██▓▓▓▓▒▒▒▒▒▒▒▒▒▒▒▒▒▒▒▒▒▒▒▒▒▒▒▒▒▒▓▓▒▒▓▓▒▒▓▓▒▒▒▒▒▒▒▒▒▒▒▒▒▒▒▒▒▒▒▒▒▒▒▒▒▒▒▒▓▓████████
████████▓▓██▓▓██▓▓▓▓▓▓▓▓▓▓▓▓▓▓▓▓▓▓▓▓▓▓▓▓▓▓▓▓▓▓▓▓▓▓▓▓▓▓▓▓▓▓▓▓▓▓▓▓▓▓▓▓▓▓████▓▓██████████████████████▓▓▓▓▒▒▒▒▒▒▒▒▒▒▒▒▒▒▒▒▓▓▓▓▒▒▓▓▒▒▒▒▒▒▒▒▒▒▒▒▒▒▒▒▒▒▒▒▒▒▒▒▒▒▒▒▒▒▒▒▒▒▓▓▓▓▓▓▒▒▒▒▒▒▒▒▒▒▒▒▒▒▓▓▒▒▓▓▓▓██
████▓▓██▓▓██▓▓▓▓▓▓▓▓▓▓▓▓▓▓▓▓▓▓▓▓▓▓▓▓▓▓██▓▓▓▓▓▓▓▓▓▓▓▓▓▓▓▓▓▓▓▓████▓▓████▓▓██████████████████▓▓▒▒▒▒▒▒▒▒▒▒▒▒▒▒▒▒▒▒▒▒▒▒▒▒▒▒▒▒▒▒▒▒▒▒▒▒▒▒▒▒▒▒▒▒▒▒▒▒▒▒▒▒▒▒▒▒▒▒▒▒▒▒▒▒▒▒▒▒▒▒▒▒▒▒▒▒▒▒▓▓▓▓▓▓▒▒▒▒▒▒▓▓▒▒▓▓▒▒
▓▓▓▓██▓▓████▓▓▓▓▓▓▓▓▓▓▓▓▓▓▓▓▓▓▓▓▓▓▓▓▓▓▓▓▓▓▓▓▓▓▓▓▓▓▓▓▓▓▓▓██████████████████████████▓▓▓▓▒▒▒▒▒▒▒▒▓▓▒▒▒▒▒▒▒▒▒▒▒▒▒▒▒▒▒▒▒▒▒▒▒▒▒▒▒▒▒▒▒▒▒▒▒▒▒▒▓▓▓▓▓▓▓▓▓▓▓▓▒▒▒▒▒▒▒▒▒▒▒▒▒▒▒▒▒▒▒▒▒▒▒▒▒▒▒▒▓▓▓▓▓▓▒▒▒▒▒▒▒▒▓▓
▓▓▓▓████▓▓▓▓▓▓▓▓▓▓▓▓▓▓▓▓▓▓▓▓▓▓▓▓▓▓▓▓▓▓▓▓▓▓▓▓████▓▓▓▓▓▓████▓▓████████████████▓▓▒▒▒▒▒▒▒▒▓▓▒▒▒▒▒▒▒▒▒▒▒▒▒▒▒▒▒▒▒▒▒▒▒▒▒▒░░░░░░░░░░░░░░░░░░░░░░▓▓▓▓▓▓▓▓▓▓▓▓▓▓▓▓▓▓▓▓▒▒▒▒▒▒▒▒▒▒▒▒▒▒▒▒▒▒▒▒▓▓▓▓▒▒▒▒▓▓▒▒▓▓
▓▓██▓▓▓▓▓▓▓▓▓▓████▓▓▓▓▓▓▓▓▒▒▒▒▓▓▓▓▓▓▓▓▓▓▓▓▓▓▓▓▓▓▓▓██████████████████▓▓▒▒▒▒▒▒▒▒▒▒▓▓▒▒▒▒▒▒▒▒▒▒▒▒▒▒▒▒▒▒▒▒▒▒▒▒▒▒▒▒▒▒░░░░░░░░░░░░          ░░▒▒██████▓▓▓▓▓▓▓▓▓▓▓▓▓▓▒▒▒▒▒▒▒▒▒▒▒▒▒▒▒▒▒▒▓▓▓▓▒▒▓▓▓▓▒▒▓▓
██▓▓▓▓▓▓▓▓██▓▓▓▓▓▓▓▓▓▓▓▓▒▒▓▓▓▓▓▓▓▓▓▓▓▓▓▓▓▓▓▓▓▓██▓▓▓▓██████████▓▓▒▒▒▒▒▒▒▒▓▓▓▓▒▒▒▒▒▒▒▒▒▒▒▒▒▒▓▓▓▓▓▓▓▓▓▓▒▒▒▒▒▒▒▒░░░░░░░░░░░░░░              ░░██████████▓▓▓▓▓▓▓▓▓▓▓▓▒▒▒▒▒▒▒▒▒▒▒▒▒▒▒▒▓▓▓▓▒▒▓▓▓▓▒▒▒▒
▓▓▓▓▓▓▓▓▓▓▓▓▓▓▓▓▓▓██▓▓▓▓▓▓██▓▓██▓▓▓▓▓▓██▓▓▓▓▓▓▓▓▓▓██████▓▓▒▒▒▒▒▒▒▒▓▓▒▒▒▒▒▒▒▒▒▒▒▒▒▒▒▒▓▓▓▓▓▓▓▓▓▓▓▓▓▓▒▒▒▒▒▒▒▒░░░░░░░░░░░░░░░░                ▒▒████████████▓▓▓▓▓▓▓▓▒▒▒▒▒▒▒▒▒▒▒▒▒▒▒▒▓▓▒▒▒▒▓▓▒▒▒▒▓▓
▓▓▓▓▓▓▓▓▓▓▓▓██▓▓▓▓▓▓▓▓▓▓▓▓▓▓▓▓██▓▓▓▓▓▓████████████▓▓▒▒▒▒▒▒▓▓▓▓▒▒▒▒▒▒▒▒▒▒▒▒▒▒▒▒▓▓▓▓▓▓▓▓██████▓▓▓▓▓▓▒▒▒▒▒▒▒▒░░░░░░░░░░░░░░                  ░░██████████████▓▓▓▓▓▓▒▒▒▒▒▒▒▒▒▒▒▒▒▒▓▓▒▒▒▒▓▓▓▓▒▒▓▓██
▓▓▓▓▓▓▓▓▓▓▓▓▓▓▓▓▓▓▓▓▓▓██▓▓▓▓██▓▓██████████████▓▓▒▒▒▒▒▒▓▓▒▒▒▒▒▒▒▒▒▒▒▒▒▒▓▓▓▓▓▓▓▓▓▓████████████▓▓▓▓▓▓▒▒▒▒▒▒▒▒░░░░░░░░░░░░                      ████▓▓██████▓▓██▓▓▒▒▒▒▒▒▒▒▒▒▒▒▒▒▓▓▒▒▒▒▒▒▒▒▓▓██████
▓▓▓▓▓▓▓▓▓▓▓▓▓▓▓▓████▓▓██▓▓██████████▓▓██▓▓▒▒▒▒▒▒▒▒▓▓▒▒▒▒▒▒▒▒▒▒▒▒▒▒▓▓▓▓▓▓▓▓████████████████▓▓▓▓▓▓▒▒▒▒▒▒▒▒░░░░░░░░░░░░░░░░                    ██████████▓▓▓▓▓▓▒▒▒▒▒▒▒▒▒▒▒▒▓▓▓▓▒▒▒▒▓▓▒▒▓▓████████
▓▓▓▓▓▓▓▓▓▓▓▓▓▓██▓▓██▓▓██████████████▓▓▒▒▒▒▒▒▒▒▓▓▒▒▒▒▒▒▒▒▒▒▒▒▓▓▓▓▓▓▓▓██████████████████████▓▓▓▓▓▓▒▒▒▒▒▒▒▒░░░░░░░░░░░░░░░░                    ██████████▓▓▓▓▒▒▒▒▒▒▒▒▒▒▓▓▓▓▒▒▒▒▓▓▒▒▓▓████████████
▓▓▓▓▓▓▓▓▓▓▓▓▓▓▓▓▓▓▓▓▓▓██████████▓▓▒▒▒▒▒▒▓▓▓▓▒▒▒▒▒▒▒▒▒▒▒▒▓▓████████████████████████████████▓▓▓▓▒▒▒▒▒▒▒▒▒▒░░░░░░░░░░░░░░░░░░░░                ██▓▓██▓▓▓▓▒▒▒▒▒▒▒▒▒▒▒▒▓▓▒▒▒▒▓▓▒▒▓▓████████████████
▓▓▓▓▓▓▓▓▓▓▓▓██▓▓██████████████▒▒▒▒▒▒▒▒▓▓▒▒▒▒▒▒▒▒▒▒▒▒▓▓██████████████████████████████████▓▓▓▓▓▓▒▒▒▒▒▒▒▒▒▒░░░░░░░░░░░░░░░░░░░░                ██▓▓▓▓▓▓▒▒▒▒▒▒▒▒▒▒▒▒▓▓▒▒▒▒▓▓▓▓████████████████████
██▓▓▓▓██▓▓▓▓██████████████▒▒▒▒▒▒▒▒▓▓▒▒▒▒▒▒▒▒▒▒▒▒▒▒▓▓████████████████████████████████████▓▓▓▓▓▓▒▒▒▒▒▒▒▒▒▒░░░░░░░░░░░░░░░░░░░░                ▓▓▒▒▒▒▒▒▒▒▒▒▒▒▒▒▓▓▒▒▒▒▒▒██████████████████████████
▓▓▓▓▓▓▓▓▓▓████████████▒▒▓▓▒▒▒▒▓▓▓▓▒▒▒▒▒▒▒▒▒▒▒▒▓▓████████████████████████████████████████▓▓▓▓▓▓▒▒▒▒▒▒▒▒▒▒░░░░░░░░░░░░░░░░░░░░                ▒▒▒▒▒▒▒▒▒▒▓▓▒▒▒▒▒▒▓▓████████████████████████▓▓████
▓▓████████████████▓▓▒▒▒▒▒▒▒▒▓▓▓▓▒▒▒▒▒▒▒▒▒▒▓▓████████████████████████████████████████████▓▓▓▓▓▓▒▒▒▒▒▒▒▒▒▒░░░░░░░░░░░░░░░░░░                ░░▒▒▒▒▓▓▓▓▒▒▒▒▒▒▓▓██████████████████████████████████
▓▓▓▓▓▓████████████▒▒▒▒▒▒▒▒▓▓▓▓▒▒▒▒▒▒▒▒▓▓████████████████████████████████████████████████▓▓▓▓▓▓▒▒▒▒▒▒▒▒▒▒░░░░░░░░░░░░░░░░░░                ░░▓▓▒▒▒▒▒▒▒▒▓▓██████████████████████████████████████
██▓▓████████████▒▒▓▓▓▓▒▒▓▓▓▓▒▒▒▒▒▒▓▓████████████████████████████████████████████████████▓▓▓▓▓▓▒▒▒▒▒▒▒▒░░░░░░░░░░░░░░░░░░                  ▒▒▒▒▒▒▓▓████████████████████████████████████████████
██████████████▓▓▓▓▒▒▒▒▒▒██▒▒▒▒██████████████████████████████████████████████████████████▓▓▓▓▒▒▒▒▒▒▒▒▒▒░░░░░░░░░░░░░░░░░░                ▒▒▓▓██████████████████████████████████████████████████
██████████████▒▒▒▒▓▓▒▒▓▓████████████████████████████████████████████████████████████████▓▓▓▓▒▒▒▒▒▒▒▒▒▒░░░░░░░░░░░░░░░░░░              ░░██████████████████████████████████████████████████████
██████████████▓▓▒▒▒▒▓▓██████████████████████████████████████████████████████████████████▓▓▓▓▒▒▒▒▒▒▒▒▒▒░░░░░░░░░░░░░░░░░░              ▓▓██████████████████████████████████████████████████████
██████████████▒▒▓▓████████████████████████████████████████████████▓▓████████████████████▓▓▓▓▒▒▒▒▒▒▒▒▒▒░░░░░░░░░░░░░░░░              ░░████████████████████████████████████████████████████████
██████████████▓▓██████████████████████████████████████▓▓▒▒▒▒▒▒▒▒▒▒▒▒▒▒██████████████████▓▓▓▓▒▒▒▒▒▒▒▒▒▒░░░░░░░░░░░░░░░░░░          ░░██████████████████████████████████████████████████████████
████████████████████████████████████████▓▓▓▓▒▒▒▒▒▒▒▒▒▒▒▒▒▒▒▒▒▒▒▒▒▒▒▒▒▒▒▒████████████████▓▓▓▓▒▒▒▒▒▒▒▒▒▒░░░░░░░░░░░░░░░░          ░░████████████████████████████████████████████████████████████
████████████████████▓▓▓▓▒▒▓▓▒▒▒▒▒▒▒▒▒▒▒▒▓▓▓▓▓▓▓▓▓▓▓▓▓▓▓▓▓▓▓▓▓▓▓▓▓▓▓▓▓▓▓▓▓▓██████████████▓▓▓▓▒▒▒▒▒▒▒▒▒▒░░░░░░░░░░░░░░░░░░░░    ░░██████████████████████████████████████████████████████████████
████████████████████████████▓▓▓▓▒▒▒▒▒▒▒▒▒▒▒▒▒▒▒▒▒▒▒▒▒▒▒▒▒▒▒▒▒▒▒▒▒▒▒▒▒▒▒▒▒▒▓▓████████████▓▓▓▓▒▒▒▒▒▒▒▒▒▒░░░░░░░░░░░░░░░░░░░░░░░░████████████████████████████████████████████████████████████████